##########
#   .....#
# ######.#
#% # .# .#
#% #\.# %#
#*..*...=#
##########