#######################
#   ##.............%.##
#   ##  ######## ## .##
#   #   ######## ## ..#
#  ...................#
#      \              #
#######################